Complexity Analysis:

Space Analysis:

Testcases:

# Notes: 
Longer texts yield more accurate results, whereas short cipertexts with unusual letters such as x and q tend to fail.
Text in other languages is also more likely to fail.

Key = 'k'

logarithms -> wwqxtsmrig - Success
inpotatoes -> vrjdrfmysg - Success
helloworld -> npctjdghfx - Failed

peregrines -> fpwjxbnmsg - Success

bringmethis -> dnfgxxqxxrq - Success 
meetateight -> qpalmjqprjw - Success
killthatrat -> tcctrqhxgkw - Success

thedocumentsarebelowit -> kuaojnxnsywpswqwipmvqe - Success
forworlddominationbruh -> pwwijbsqtwhklzilvunqyi - Success
thequeenisnolongerhere -> kuayzoqmmgjbnivfitghdt - Success

mothersdayisnext -> qwvckblqpndplyak - Failed
fathersdayislast -> ptvckblqpndpnzbk - Success
ratattouilleisit -> ztvxrjgcmpuvqxtk - Success

hellomothersworld -> npctjxgxxzypmifif - Success
helloworldcarrots -> npctjdghfxecowlkw - Success

nexthelloworldyes -> hpzldosjnokmnvpmw - Failed
nexthelloworldbark -> hpzldosjnokmnvsnuc - Failed
nexthelloworldbased -> hpzldosjnokmnvsnwdq - Success
nexthelloworldbarks -> hpzldosjnokmnvsnuct - Success

xylophonexenophobes -> cxcdqqgmsdchrtkhldt - Failed
xylophonexenophobias -> cxcdqqgmsdchrtkhlbfz - Failed
xylophonexenophobetobias -> cxcdqqgmsdchrtkhldsfahla - Failed
excellentendeavorfellows -> syljikqmdzjzpznhuqjdvdfa - Failed
thedocumentshavebeensecured -> kuaojnxnsywpzznmldjiktsluxb - Success

comeback -> xwdjcfkz - Failed
atnine -> yauwso - Success
eleven -> sqarkc - Failed

Key = 'm'

findmeattheback -> vuhfdjmjmrsvgaj - Success
attackfrombehind -> dhktlbybgnuzmklv - Success
submarineatfourthirty -> hidgevlcqvdukgopklurr - Success 
bringbacksomecheeseandgrapes -> zlvrqkmncfnccazyqjijblexldld - Success
ripeapple -> uufpezqkq - Success

key = 's'

somebodyoncetoldme -> tfxteqawurljresqiz - Success
xylophoneswithmacaroni -> ktvdgwimsbrwrqtvzkyblo - Success
xyjxjyxjs -> kthriipae - Failed
ogre -> mmdt - Failed
ogreanddonkey -> mmdtlxasursjf - Success

key = 'p'

Hippopotomonstrosesquipedaliophobia -> ijdxpfwvdaeifdikppxeveljlbsjqxtusfx - Failed
personwithhippopotomonstrosesquipedaliophobia -> vbkhphofldqniawvbuiuhkvsqtlbativeaomknyajkoqz - Success
parangaricutirimicuaro -> vlkdmjtwwbpmpgrhkvkxcv - Success
potatosalad -> vyjdhubetmw - Success

# Other languages
yoteconozco -> myjlvurhpbe - Failed
podemosiralasocho -> vyplnubfvmkhfnmmb - Success
tequiero -> eborusnh - Failed
quetepasa -> nzfqxftkx - Failed
jemapellefrank -> cbbdosqcjybhmw - Failed

key = 'x'

thefrencharecertainlymisunderstoodbutwhetherthefaultistheirsinnotsufficientlyexplainingthemselvesorspeakingwiththatexactlimitationandprecisionwhichonewouldexpectonapointofsuchimportanceandwhichmoreoverissolikelytobecontestedbyusorwhetherthefaultmaynotbealtogetheronoursideinnotunderstandingtheirlanguagealwayssocriticallyastoknowwhattheywouldbeatishallnotdecidebuttisevidenttomewhentheyaffirmthattheywhohaveseenparishaveseeneverythingtheymustmeantospeakofthosewhohaveseenitbydaylight -> pkmdtjifilklvsnvxlcsoirqglvqcwrmfrgzjntsaojtjaglkltuobkxdvqkhtxihehimlnngoqujpsyiqbbnzbnwlnepcrkighelccjovfsbseoiljleyivtlxnxpqdblzvpztjaqljqwynclcjcqbnfuzpsymtrmibvyywhudksbqnnawylscwmquqvjhswkpzphrkbnfewukjyozcxnhfdtjldkpmkfplygomvulqccyjobaajkjarhlcohjdwavulqcvumbdljpluhrhlzcygggwclvtayrghqxaswzotqjmkzvvgqbvwtkekfdvmlaqptrhivqhxdjcjmimifijcohcwdrwrhlhokptzfguptjisvlgqnjinsoojsjagvkbxqwukxjsyjtohspnttjnoqmakykalxuivjhztqfuwkufgxjagvclpuqqnkrmzwtlribkuhukdayxkpvayqaerntruouozna - Success
itwasnottothemnottohughorrichardoreventodevotedmissbrushtheliberatorofthepentegotismwhichisastrongmartialwomanwellnourishedwelldescendedofdirectimpulsesdownrightfeelingsandlittleintrospectivepowerbroadandsimplewhycouldnoteveryonebebroadandsimplesheaskedfeelsrisewithinheronceyouthispastandmustejectuponsomeobjectitmaybeemigrationitmaybeemancipationbutwhateveritbethisobjectroundwhichtheessenceofhersoulisdailysecretedbecomesinevitablyprismaticlustroushalflookingglasshalfpreciousstonenowcarefullyhiddenincasepeopleshouldsneeratitnowproudlydisplayed -> oibqvbfoeyjsxqrhlreacrjkmoowoqtqfdtqfwhufarjjqqirqpxwmjxrghvhefujkwwdyjagazjlpblkevovjhswodybvvjconpiwkshchjjbvgsaxiizckckwzgfpivanqafdqfcojklvkcdzzklgexkqlwtfxrahgsjxcdyrmtljmjsrjloibdiksnltgqnxzswdmwhmtgdrehqbxhpfysxxihskavfeiguzfmrzjnketnxvafhtstkbkwvgspqmqxqbergnzibkimxpbdzjapelgpuzvpjntygcbzqifwuujxqyuhcauoieqhnhgyjvujkchgljtvvvcvwzvrelfyqdtmrhluelkzqhmqfvultjviehfemqrmboowbqmrszqppcwmvqghdlyleuefewiglgziclpvsmtxohkhtffuktytfujpecglqnovwryfylksebwwhblcoefkqpzzogztjaqdzahhuragjdkvgzbgnhpoeeqhzhtzddseadqkqfxwltgxvmitfyqetqnozwnoigypelucfyj - Success
shehadsaidimtiredofbegginggodtooverthrowmysonbecauseallthisbusinessoflivinginthepresidentialpalaceislikehavingthelightsonallthetimesirandshehadsaiditwiththesamenaturalnesswithwhichononenationalholidayshehadmadeherwaythroughtheguardofhonorwithabasketofemptybottlesandreachedthepresidentiallimousinethatwasleadingtheparadeofcelebrationinanuproarofovationsandmartialmusicandstormsofflowersandsheshovedthebasketthroughthewindowandshoutedtohersonthatsinceyoullbepassingrightbytakeadvantageandreturnthesebottlestothestoreonthecornerpoormother -> xkmxjqzbhxykhvnaojapgrsdhdblpcxmwgxnwuplgbujcpgzklppzoicyvzaacywxebhmisfposdhulqdudtnrttjojweetmnqpepdiplxueuhyjtayctkbhgmksxxzwkwyblujblkibwdsetfoljzpdjwnpxxeiufyyxluwxebrwrqzrmmmblivmkjsntqluspwcmxfiagxkirsvqoitucuekkiijuvckyxvgxkxzivhugvyjueshqsahmkxbxvvkluhqjquqqguswlskuaztolptzjlqzoiezmbkhtfqtyarxnkqvtrjuulqdqtflgdwzlrsswxrsgmmyghttfhqtmotpljophbeghxhhdrgtwkbltjblkeykkduditjdqhekjzalqjxxihrekfzjevalrqjybsmlzyclkemvbqxaspoaaoreagggkhulxkwbbagmylerdpjxninmriduzpszcjxhboqswhymaxswjgdfyhulqjiimyosbaqpkuaurejgnywnpnlckdyktdmbihnpw - Success
ilikedtositupfrontandridethefastonesalldaylongilikeditwhentheybrushedrightupagainstthebuildingsnorthoftheloopandiespeciallylikeditwhenthebuildingsdroppedawayintothatbombedoutsqualoralittlefarthernorthinwhichpeoplethroughwindowsyoudseeapersoninhisdirtynakedkitchenspooningsouptowardhisfaceortwelvechildrenontheirbelliesonthefloorwatchingtelevisionbutinstantlytheyweregonewipedawaybyamoviebillboardofawomanwinkingandtouchingherupperlipdeftlywithhertongueandsheinturnerasedbyawhamthenoiseanddarkdroppeddownaroundyourheadtunnelactuallylived -> oolndqytljjropnhgrfiqgrivulqgqvsfztcserbtbtjcopfrovgoibxdbyjtomuieuaotsordfvcdztawrseggzyesvrqusejxxwblzyohvlfirhbaxxxcetigspwzikurkmkrghaajuauhmkotebisxgqsetacxsebeeqkfsfhsriecppkmshtkcpjobxnwllhwwldsibxreneyldbdseddzvsyvrmdvidybxqvpzymuvmiqqkyhsvnvqsfcgtadlvlqawlmfzhtvhpoevdvfjqxrqxsnqhuruhvpbzsuwfwjseixxzdmxyoiedtfzekfvruwwimjkrmyalphquevvfzgzjomeaegrkdxxzrqpwqfvujvqvbpdyyxyqmxgamzfknhshqtqfcufqkjhofgesiepyilrkwoeuhegxzdxxzqfzhovxfntkulkmurmieabswseuawsjxhozycayjwgjuebynwlmuckjmcyqpiozoiydieqfpqlkiihfbdzbagpxwglcqiqksbbsaieuipm - Success

key = 'a'

twentymoreleft -> wqpcizjxyhvtwj - Failed
twentyshipsleft -> wqpcizwyvkksbeq - Failed
tenshipsleft -> wvlxklzvzhce - Success
fiftyshipsgone -> bkyppjxbczedtf - Success
potatochips -> vbuzihtyvkk - Success
donotbuyavocadotoast -> ibliiwrhfwtjlpihutkl - Success
verysecretmessage -> pvoebmttjyxtcadzs - Success
enter -> chuyf - Success